F 122,4,90
C               000,0,100

NO assets/textures/north.xpm
SO                assets/textures/south.xpm
WE assets/textures/west.xpm
EA assets/textures/east.xpm




        1111111111111111111111111
        100100000000000000000 0001
111111111011000001110000000000001
10000000001100000111011111111111
11110111111111011100000010001
11110111111111011101010010001
11000000110101011100000011001
1000000000000000110000001 001
10000000000000001101010010001
11000001110101011111011110N0111
11110111 1110101 101111010001
11111111 11111111111111111111