F 122,4,90
C 000,0,100

NO assets/textures/north.xpm
SO assets/textures/south.xpm
WE assets/textures/west.xpm
EA assets/textures/east.xpm

11111111111111111111111111
100000000011000000000000111111111
10110000011100000000000011111110
100100000000000000000000111111111
111111111011000001110000000000001
100000000011000001110111111111111
111101111111110111000000100000001
111101111111110111010100100000001
110000001101010111000000100000001
100000000000000011000000100000001
100000000000000011010100100000001
11000001110101011111011110N000001
111101111111010111011110100000001
111111111111111111111111111111111