F 0,0,0
C 255,0,100

NO assets/textures/north.xpm
WE assets/textures/west.xpm
SO assets/textures/south.xpm
EA assets/textures/east.xpm


11111111111111111111111111    
100000000011000000000000111111111
101100000111000000000000111111101
100100000000000000000000111111111
111111111011000001110000000000001
100000000011000001110111111111111
111101111111110111000000100000001
111101111111110111010100100000001
110000001101010111000000100000001
100000000000000011000000100000001
100000000000000011010100100000001
110000011101010111110111100000001
111101111111010111011110100000001
111111111111111111111111111111111