C 198,231,255
F 182,162,142

NO assets/textures/north.xpm
WE assets/textures/west.xpm
SO assets/textures/south.xpm
EA assets/textures/east.xpm

        1111111111111111111111111
        1000000000110000000000001
        1011000001110000000000001
        1001000000000000000000001
111111111011000001110000000000001
100000000011000001110111111111111
11110111111111011100000010001
11110111111111011101010010001
11000000110101011100000010001
10000000000000001100000010001
100000N0000000001101010000001
1100000111010101111101111000111
11111111111111111111111111111