C 198,231,255
F 154,126,111

NO assets/textures/pic_blue.png
WE assets/textures/pic_green.png
SO assets/textures/pic_red.png
EA assets/textures/pic_yellow.png

11111111111111111111111111111
11110111111111011100000010001
11110111111111011101010010001
11000000110101011100N00010001
1000000000000001100000010001 
100000000000000000000000001
1000000000000000000000000011
11111111111111111111111111111